1111111111111111
1000000100000001
1000100000001001
1PPCE11100001111
11111111111