1111111111
10000F0001
1000000001
1000000001
1000E00001
1000000001
10C0C0C001
1000000001
1000P00001
1111111111