1111111111111
1000000000001
1000000000001
100C00000C001
100000H000001
1000000000001
1110V0E0V0111
1000000000001
100000H000001
100000000C001
1000000000001
1P00000000001
1111111111111