1111111111111
1000001000001
1000001000001
100C00100C001
1000001000001
100000H000001
11111VEV11111
100000H000001
1000001000001
100000100C001
1000001000001
1P00001000001
1111111111111