111111111111111
1P000C0000C0001
111111100000001
100000100000001
100000100000001
1000C0100000001
100000100000001
10000010C000001
100000100000001
1000001100H0011
100000000000001
100000000000001
100000V00000001
10E000000000001
100000000000001
111111111111111