11111111111111111111
10000000000000000001
10000000000000000001
1000000000C000000001
10000000000000000001
10000000000000000001
1C000000000000000001
10000000C00000000001
1P000000000000000001
100000C0000000000001
10000000000000000001
10000000000000000001
10000000000000000001
10000000000000000001
10000000000000000001
10000000000000000001
100000000C0000000001
10000000000000000001
100000000000000E0001
11111111111111111111