1111111111111111
10000Z0100000001
1000100000001001
1PPCE11100000001
1111111111111111