1111111111111111
1000000100000001
1110000000001001
1P1C0E1110000001
1111111111111111
1111111111111111
1000000100000001
1110100000001001
1010011100000001
1111111111111111