1111111111111111111111111111111111
1000000000000000000000000000000001
1P000000000000000000000000000000E1
10000000C000000000C000000C00000001
1000000000000000000000000000000001
1111111111111111111111111111111111
1000000000000000000000000000000001
1000000000000010011110000000000001
1000000000000100000010000000000001
1000000000001000011110000000000001
1000000000001111010000000000000001
1000000000000001011110000000000001
1000000000000000000000000000000001
1111111111111111111111111111111111