111111111111111
10000F000000011
100001000000011
10000F000000011
100000000000011
10000000000C001
1000E0000F00011
1000P0000000011
111111111111111