1111111111111
1000000000001
100000000E001
10000C0000001
1000000000001
10P0000000001
1111111111111